anticipate	予想する、予期する
appreciate	感謝する
crucial	極めて重要な
devise	考案する
distinct	明確な、独特な
disturb	邪魔する、不安にさせる
eliminate	なくす、排除する
incorporate	取り入れる
integrate	一体化する、組み入れる
involve	伴う、必要とする
magnificent	壮観な、壮大な
modest	ささやかな、謙虚な
percieve	知覚する
perspective	展望、観点
persuade	説得する、促す
privilege	特権、特典
prominent	著名な、顕著な
respectively	それぞれの、各々の
retain	記憶する、維持する
seize	つかむ、つかみ取る
strain	負担、重圧
subsequent	その後の
variation	変化、変動
